'	'
ص	ص
ق	ق
م	م
ب	ب
أ	أ
و	و
ن	ن
ت	ت
خ	خ
ش	ش
ع	ع
ك	ل
د	د
ف	ف
ح	ح
ظ	ظ
ط	ط
ج	ج
ي	ي
ث	ث
a	a
ر	ر
س	س
ز	ز
غ	غ
ا	ا
ة	ه
ل	ل
ذ	ذ
ه	ه
ض	ص
ء	ء
ئ	ى
إ	ا
ى	ى
A	A
B	B
C	C
D	D
آ	ا
ؤ	و
ژ	ر
P	P
V	V
g	g
e	e
Q	Q
ـ	ـ
S	S
t	t
l	l
E	E
r	r
h	h
f	f
N	N
i	i
o	o
s	s
n	n
u	u
O	O
T	T
I	I
d	d
p	p
پ	پ
M	M
R	R
b	b
J	J
U	U
H	H
m	m
c	c
L	L
k	k
y	y
F	F
K	K
Y	Y
گ	گ
G	G
v	v
W	W
Z	Z
j	j
q	q
w	w
x	x
z	z
چ	چ
